C 255,8,1
NO ./path_to_the_north_texture
SO ./path_to_the_south_texture

EA ./path_to_the_east_texture
WE ./path_to_the_west_texture

F 244,1,23

        111111111111111111111111
        100000000011000000000001
        100000000011000000000001
        101100010111000000000001
        100100110000000000000001
11111111101100010111000000000001
10000000001100000111011111111111
10000011111111011100000010001
10000011111111011101010010001
10000000110101111100000010001111
100N0001000001   100011000000101
10000000000001111100010010001101
11100011111110000000001111111111
11000001110101011110111100111
11111111 1110101 101111010001
1111 11111111111 111111111111