NO ./path_to_the_north_texture
SO ./path_to_the_south_texture
EA ./path_to_the_east_texture
WE ./path_to_the_west_texture 

F 244,1,23
C 255,   0, 1

        1111111111111111111111111 
        1000000000110000000000001
        1011000101110000000000001
        1001001100000000000000011
111111111011000101110000000000001
100000000011000001110111111111111
11110111111111011100000010001
11110111111111011101010010001
1100000011010111110000001000111
100000010000N1   100011000000101
1000000000000011110001001000111
11111111111111111111111111111
110000011101010111110111100111
11111111 1110101 101111010001
1111 11111111111 111111111111
