NO textures/wall32x32.png
SO textures/Tile_04-128x128.png
EA textures/Tile_14-128x128.png
WE textures/Tile_16-128x128.png

C 0, 255, 0
F 0, 0, 255

111111111111111111111
100000000000000000001
100000000000000000001
101101010101010101011
1000000000000000000N1
100000000000000000011
111111111111111111111