NO Mandatory/textures/Tile_25-128x128.png
SO Mandatory/textures/Tile_15-128x128.png
EA Mandatory/textures/Tile_22-128x128.png
WE Mandatory/textures/Tile_02-128x128.png

C 232, 76, 65
F 186, 181, 181

        111111111111111111111111
        100000000011000000000001
        100000000011000000000001
        101100010111000000000001
        100100110000000000000001
11111111101100010111000000000001
10000000001100000111011111111111
10000011111111011100000010001
10000011111111011101010010001
1000000011010111110000001000111
1000001000001   100011000000101
10000000000001111100010010001101
11100011111110000000001111111111
11N00001110101011110111100111
11111111 1110101 101111010001
1111 11111111111 111111111111