NO Bonus/textures/walls/north_wall.png
SO Bonus/textures/walls/south_wall.png
EA Bonus/textures/walls/east_wall.png
WE Bonus/textures/walls/west_wall.png

C 232, 76, 65
F 186, 181, 181

        111111111111111111111111
        100000000011000000000001
        100000000011000000000001
        101100010111000000000001
        100100010000000000000001
11111111101100010111000000000001
10000000001100000111011111111111
10000011111111D11100000010001
10000011111111000D01010010001
1000001111011111110000001000111
100001D00W01   1000110000001011
10000000000111111100010010001101
11100011111110000000001111111111
1100001110101011110111100111
11111111 1110101 101111010001
1111 11111111111 111111111111