C 255,8,1
NO ./path_to_the_north_texture
SO ./path_to_the_south_texture

EA ./path_to_the_east_texture
WE ./path_to_the_west_texture

F 244,1,23


11111111111111111111111111111111
10000000000000000000000000000001
10000000000000000000000000000001
10000000000000000000000000000001
10000000000000000000000000000001
10000000000000000000000000000001
100N0000000000000000100000000001
10000000000000000000000000000001
10000000000000000000000000000001
10000000000000000000000000000001
11111111111111111111111111111111